{
  "begin": {"x": "62.5","y": "110.5"},
  "routes": [{"x": "104","y": "51"},
            {"x": "156","y": "97"},
            {"x": "213","y": "60"},
            {"x": "272","y": "99"},
            {"x": "318","y": "76"},
            {"x": "401","y": "46"},
            {"x": "460","y": "99"},
            {"x": "506","y": "75"},
            {"x": "563","y": "104"}],
  "end": {"x": "600","y": "10"},
}
